NO srcs/imgs/colorstone.xpm
SO srcs/imgs/redbrick.xpm
WE srcs/imgs/eagle.xpm
EA srcs/imgs/wood.xpm

F 184,119,59
C 60,80,100

                             1
                           1111
                          11011
                         11001 
                         11111
                         111     
                11111          11111
              111000111111111111000111
             11000000000000000000000011
            1100000000000000000000000011
           110000000000000000000000001111
          11000000000000000000000000011  
          110000000000000N000000000001 
          11000000000000000000000000011 
           110000000000000000000000000111
            1100000000000000000000000011
             11000000001111110000000011
              1111111111    1111111111