   NO srcs/imgs/North.xpm    
   SO srcs/imgs/South.xpm   
   WE srcs/imgs/West.xpm  
   EA srcs/imgs/East.xpm   

   F 184,119,59     
   C 60,80,100

           111             
          11011
         1100011
        110000011
111111111000000011111111111
110000000000000000000000011
 1100000000000000000000011
  1100000000W000000000011
   110000000000000000011
   10000000010000000011
   1000000011100000001
   100000011 110000001
   10000011   11000001
   1000011     1100001
   100011       110001
   10011         11001
   1011           1101
   111             111